##########################################
#    ....       .#                       #
# ###### #######.#    ...                #
#               .#                       #
#######.#### ###. .    ..                #
#      .       ####                      #
#      .       # #  .....                #
#      .       # #                       #
#      .       # #                       #
#      .       #                         #
#      .         #                       #
#      .       # #       ......          #
#      .       # #                       #
#              # #           ..          #
#              # #                       #
#              #                         #
##########################################